0000000000000000000000000000000000000000000000000
0                                               0
0                                               0
0                                               0
0   0                                           0
0   0                                           0
0   0                                           0
0   0                                           0
0   0                                           0
0                                               0
0            0               0                  0
00000        0000            0     p            0
0   0        0               0           ===    0
0   0        0               0                  0
0   0   00000000000  0         000000000000000000
0   0                0                          0
0                    0                          0
0                    00000000    00000000000    0
0                           0                   0
0                           0                   0
0000000000000000000000000000000000000000000000000